+++++++++
+++++++++
++++x++++
+++xxx+++
++++x++++
+++++++++
+++++++++
